SO ./path_to_the_south_texture
NO ./path_to_thaaae_north_texture
WE ./path_to_the_west_texture
EA ./east

F 220,100,1
C                       225,30,0

11111111111111111111111111111111111111
11111111100000000011111111111
10000000001100000111011111111
11110111111111011100000010001111111111
11110111111111011101010010001111111111
11000000110101011100000010011
100000000000S000110000010001
11111111000000001101011111111
1111111111111111111111
