NO ./textures/gnawa/zelijv2.xpm
SO ./textures/gnawa/wall2_pixel.xpm
WE ./textures/gnawa/zelijv1.xpm
EA ./textures/gnawa/textured_wall.xpm
F 220,100,22
C 225,30,1

1111111111111111111111111
1000000000000000000000001
1011110111111111110111101
1010000100000000010000101
1010111101111111011110101
1010100001000000010000101
1111111111111111111111111
1111111111111111111111111
1010101111011111011100101
1010101000010000010000101
1010101011010111010110101
1010000010010000010000001
1011111110010111011111101
1000000000000N00000000001
1111111111111111111111111
1111111111111111111111111