NO ./textures/gnawa/zelijv2.xpm
SO ./textures/gnawa/wall2_pixel.xpm
WE ./textures/gnawa/zelijv1.xpm
EA ./textures/gnawa/textured_wall.xpm
F 220,100,22
C 225,30,25

1111111111111111111111111111111111          
10000000000000000000S0111111100111
1000000000000000000000001111111111 
1000000000000000000000000000000111
1000000000000000000000000000000111
1000000000000000000000000000000111
1111111111111111111111111111111111          