NO ./textures/gnawa/zelijv2.xpm
SO ./textures/gnawa/wall2_pixel.xpm
WE ./textures/gnawa/zelijv1.xpm
EA ./textures/gnawa/textured_wall.xpm

F 220,100,22
C 225,30,1

        1111111111111111111111111
        1000000000000001000000001
        1000000000000001000000001
        1000000000000001100000001
        1000000000000000000000001
        1000000000000000000000001
        1000000000000000111111111
1111111110000000001010001
1010101110111111101110101
1010001000100010001000101
1011101010101010101011101
1000100010101000101000001
1110111011101110111011111
1000000010000000100000001
1011111011111110111111101
1010000000000N00000000011
1010111111111111111110101
1010000010000000000000101
1011111010111111111011101
1000001000100000001000001  
1111111111111111111111111
qq